1111111111111111
1000000000000101
1000000000000001
1000000000000001
1010003011000001
1010011110000001
1010000000010001
1000000000011001
1000000000011001
1000020000000001
1000000000011001
1011000000000001
1011000000000001
1001000000000001
1000000000000011
1111111111111111