1111111111111111
1000000000000001
1000030000000001
1100000000000001
1100000111000011
1000000000000001
1000000000000001
1000000000000001
1110000000000001
1100000010000021
1000000010000001
1000000000000001
1000000000000001
1000000000000011
1000000000001111
1111111111111111