1111111111111111
1000000000000001
1000000000000001
1000000000000301
1000001100000001
1000000100000001
1100000000000001
1100000000000001
1100000000000001
1000000011000001
1000000001000001
1011110000000001
1000100000000001
1000000001000011
1200000001000001
1111111111111111