1111111111111111
1000000000000001
1000000000000001
1110000001103001
1110000000100001
1000010000000001
1000010000000001
1000010000000001
1000110000000001
1000000000011001
1002000000001101
1000011110000001
1000000000000001
1000000000000001
1001000000000011
1111111111111111