1111111111111111
1000000000001001
1100000000000001
1000000000000001
1000000000000001
1000000000000001
1000000300000001
1000000000000001
1000000000000001
1000000000000001
1000011111100001
1000010000002001
1000000000000001
1000000000000011
1000010000000001
1111111111111111