1111111111111111
1000000000000001
1000000000000001
1000000000300101
1000110011001101
1000110011001101
1000000000000001
1000002000000001
1000110011000001
1000110011000001
1000000000001101
1000110011001101
1000110000000001
1000000000000111
1000000000000111
1111111111111111