1111111111111111
1000000000000001
1000000000000001
1000000000000001
1000000000000001
1000000000000001
1003011000000011
1000011000000001
1000000000000001
1111000000000001
1000000000000001
1000000000000001
1000000000100001
1000000000100001
1200000000100001
1111111111111111